1111111111111111111111111111111111
100P00000000000C00000C000000000001
1010010100100000101001000000010101
1010010010101010001001000000011111
100000000C00C0000000000000000E00C1
1111111111111111111111111111111111