111111
100001
101101
1P0001
100001
100101
1C0001
101001
100001
101101
100001
100001
100001
100001
100001
100001
100001
100001
100001
100001
1C1101
100001
1011E1
100101
101101
1001C1
111111