111111111111111111111111111111111111111111111111111
10000000000000000000C00000000000000000000000E000001
100000P000000000000000000000000000C0000000000000001
111111111111111111111111111111111111111111111111111
